rgby........G.......
................r...
.....R..........r...
...Y............r...
................rrr.
....####............
...#    #g#ggg#ggg..
....####............
....................
...b................
.....b...........R..
.......b............
.........b..........
....................
......yyyyyyyy.....#
......y......y.....#
......y......y.....#
......y......y.....#
.........B....gggyyy
..........##########
